PLD = "countries/Not Poland.txt" #due to random crashes related to the POL tag, PLD was created as a fix to circumvent the unfixable/unidentifiable crashes
HRL = "countries/House of Representatives Libya.txt"
ALF = "American Liberation Front.txt"
SHB = "countries/Al-Shabaab.txt"
TAL = "countries/Taliban.txt"
AAS = "countries/Ansar al-Sharia.txt"
HEZ = "countries/Hezbollah.txt"
HOU = "countries/Houthi Yemen.txt"
HTS = "countries/Hayat Tahrir al-sham.txt"
ATP = "countries/Antifa Buffalo.txt"
PDX = "countries/Portland.txt"
NSC = "countries/NSC131.txt"
ATH = "countries/Antifa Huston.txt"
ATW = "countries/Atom Waffen.txt"
ROJ = "countries/Rojava.txt"
FSA = "countries/Free Syrian Army.txt"
IKA = "countries/Army of God.txt"
BGF = "countries/Black Guerrilla Family.txt"
AYN = "countries/Aryan Nations.txt"
AYB = "countries/Aryan Brotherhood.txt"
NRT = "countries/Nortenos.txt"
SRN = "countries/Surenos.txt"
LWK = "countries/Loyal White Knights of KKK.txt"
BLA = "countries/Black Liberation Army.txt"
APA = "countries/American People's Liberation Army.txt"
BOA = "countries/Free Baptists of America.txt"
HLA = "countries/Hells Angels.txt"
HWM = "countries/Highway Men.txt"
NSM = "countries/National Socialist Movement.txt"
PTF = "countries/Patriot Front.txt"
NYP = "countries/New York Police Department.txt"
FLM = "countries/Florida Militia.txt"
HUM = "countries/Hutaree Militia.txt"
CLM = "countries/California Militia.txt"
TFM = "countries/Texas Light Foot Militia.txt"
TNM = "countries/Texas Nationalist Movement.txt"
ABR = "countries/Arizona Border Recon.txt"
PCR = "countries/People for Constitutional Freedom.txt"
WLF = "countries/Washington Light Foot Militia.txt"
MIM = "countries/State of Michigan.txt"
LRA = "countries/La Raza.txt"
BMF = "countries/Black Mafia Family.txt"
RGA = "countries/Red Guards Los Angeles.txt"
RGC = "countries/Red Guards Charlotte.txt" 
RGP = "countries/Red Guards Pittsburgh.txt" 
TRG = "countries/Texas Red Guards.txt"
VER = "countries/Vermont.txt"
FLA = "countries/Florida.txt"
LOU = "countries/Louisiana.txt"
SAT = "countries/Satanic Temple.txt"
RRR = "countries/Redneck Revolt.txt"
NNN = "countries/Navajo Nation.txt"
GMA = "countries/Green Mountain Anarchist Collective.txt"
FAA = "countries/Free Army of America.txt"
AOF = "countries/American Black Army.txt"
GMC = "countries/Green Mountain Company.txt"
ALA = "countries/Alabama.txt"
GRA = "countries/Georgia.txt"
STC = "countries/South Carolina.txt"
MSS = "countries/Mississippi.txt"
ORE = "countries/Oregon.txt"
WAS = "countries/Washington.txt"
NMX = "countries/New Mexico.txt"
CHZ = "countries/Capitol Hill Autonomous Zone.txt"
ARZ = "countries/Arizona.txt"
RCA = "countries/Rose City Antifa.txt"
BBC = "countries/Black Bloc Cascadia.txt"
NK2 = "countries/North Korea2.txt"
NK3 = "countries/North Korea3.txt"
SAR = "countries/Saudi Arab Republic.txt"
JAH = "countries/Jaysh Alfath.txt"
ARR = "countries/Arabian Republic.txt"
ROC = "countries/Royal Coalition.txt"
SRP = "countries/Republika Srpska.txt"
FPM = "countries/Florida Patriot Movement.txt"
LOS = "countries/League of The South.txt"
RPP = "countries/Rural Peoples Party.txt"
GUC = "countries/Gulf Cartel.txt"
SIN = "countries/Sinola Cartel.txt"
ZET = "countries/Los Zetas.txt"
LFM = "countries/La Familia Michoacana.txt"
CDJ = "countries/Cartel de Jalisco.txt"
ZAP = "countries/Zapatista Army of National Liberation.txt"
CAS = "countries/Casas Grandes.txt"
USN = "countries/United States Naval Command.txt"
BRN = "countries/Brown Berets.txt"
CAC = "countries/Cascadia.txt"
TDF = "countries/Tigray.txt"
WLS = "countries/Wilayah Sina.txt"
MUS = "countries/Muslim Brotherhood.txt"
TAR = "countries/TibetAR.txt"
XIN = "countries/Xinjiang.txt"
ETL = "countries/East Turkestan Liberation Organization.txt"
HUT = "countries/Hizb ut-Tahrir.txt"
EFF = "countries/Economic Freedom Fighters.txt"
MMS = "countries/MS13.txt"
BND = "countries/Bandidos.txt"
LCN = "countries/La Cosa Nostra.txt"
UNN = "countries/United Nations.txt"
USC = "countries/USC.txt"
GAL = "countries/Galacian Liberation Front.txt"
RSR = "countries/Republican Front.txt"
SNS = "countries/Spanish National State.txt"
BAR = "countries/Barcelona Anarchist Collective.txt"
NFJ = "countries/Northern Fleet Joint Strategic Command.txt"
PUR = "countries/Patriotic Union of Russia.txt"
CHU = "countries/Chuvashia.txt"
FPR = "countries/Commie France.txt"
FAF = "countries/Military France.txt"
NMD = "countries/normandy.txt"
FCM = "countries/franch comte.txt"
PIC = "countries/picardy.txt"
OCT = "countries/not occitania.txt"
LIM = "countries/limousine.txt"
PRV = "countries/provence.txt"
EAF = "countries/European African Islands.txt"
EPI = "countries/European Pacific Islands.txt"
GRK = "countries/Commie Greece.txt"
NCA = "countries/North Carolina.txt"
GOD = "countries/Kingdom of Heaven on Earth.txt"
MOS = "countries/Moscow Commune.txt"
PRP = "countries/Peoples Republic of Portugal.txt"
BNF = "countries/Brother Nathaniel Foundation.txt"
LDS = "countries/Church of Latter Day Saints.txt"
DUG = "countries/Dugway Clique.txt"
LCA = "countries/Los Charlines.txt"
GOL = "countries/Gol Sur.txt"
PRS = "countries/Peoples Republic of Spain.txt"
VAG = "countries/Vagos.txt"
FOL = "countries/Folkish Resistance Movement.txt"
JUA = "countries/Juarez Cartel.txt"
NPA = "countries/New People's Army.txt" 
GAU = "countries/Guangdong Military Government.txt"
CHF = "countries/Nanjing Provisional Government.txt "
ORG = "countries/Orange Free State.txt"
TRN = "countries/Transvaal.txt"
CFF = "countries/Cape Revolutionary Front.txt"
ELN = "countries/National Liberation Army.txt"
FRC = "countries/FARC.txt"
CLS = "countries/Columbian State.txt"
SND = "countries/Sindhudesh.txt"
BAL = "countries/Balochistan.txt"
ISK = "countries/ISIS Pakistan.txt"
TLP = "countries/Taliban Pakistan.txt"
IRB = "countries/Iran Balochistan.txt"
AN1 = "countries/Anarchy1.txt"
AN2 = "countries/Anarchy2.txt"
AN3 = "countries/Anarchy3.txt"
HNG = "countries/Hungarian Revolt.txt"
HUL = "countries/Harkat Mujahideen.txt"
ULF = "countries/United Liberation Front of Asom.txt"
NAX = "countries/Naxalite.txt"
ANA = "countries/Anarchist Revolt.txt"
JFR = "countries/Jefferson.txt"
STR = "countries/Stavropol.txt"
CPC = "countries/Coalition of Patriots for Change.txt"
UK2 = "countries/UK Rebellion.txt"
AG1 = "countries/Algerian republic.txt"
AG2 = "countries/Algerian islamic state.txt"
AG3 = "countries/Algerian salvation army.txt"
CIA = "countries/CIA Clique.txt"
USG = "countries/USB GOP.txt"
USP = "countries/USB Progressives.txt"
TAU = "countries/Taureg.txt"
PKK = "countries/Kurdistan Workers Party.txt"
CRM = "countries/Confederated Republic of Morocco.txt"
RRF = "countries/Rif Republic.txt"
AQI = "countries/ISWAP.txt"
NWY = "countries/Norwegian Resistance Army.txt"
SWD = "countries/Swedish Army of Salvation.txt"
JPR = "countries/Republican Japan.txt"
UFA = "countries/Ukranian Free Army.txt"
BDM = "countries/Belarus Democracy Movement.txt"
BFW = "countries/Brothers of the Wood.txt"
PRA = "countries/Polish Resistance Army.txt" 
IAI = "countries/Islamic Army in Iraq.txt" 
FIA = "countries/Free Iraqi Army.txt"
KRA = "countries/Real Karelia.txt"
KIS = "countries/Korol And Shut.txt"
RSF = "countries/Rapid Support Forces.txt"
BIA = "countries/Biafra.txt"
AMB = "countries/Ambazonia.txt"
EBN = "countries/East Benin.txt"
BDK = "countries/BDK.txt"
M23 = "countries/M23.txt"
NDC = "countries/NDC.txt"
DRO = "countries/Congo Opposition.txt"
MMK = "countries/MMK.txt"
RCO = "countries/Republic of Congo Opposition.txt"
RME = "countries/Roma.txt"
EPX = "countries/Energy Protectorate Zone.txt"
APX = "countries/Agriprotectoate of the Heartland.txt"
NEX = "countries/Northeastern Corporate Development Corridor.txt"
PDZ = "countries/Pacific Corporate Development Corridor.txt"
BRS = "countries/Brussels.txt"
GOP = "countries/PTF_GOP.txt"
LAZ = "countries/Lazistan.txt"
ADA = "countries/Adana.txt"
IST = "countries/Istanbul.txt"
TSS = "countries/Turkish Army in Syria.txt"
FCT = "countries/French Catalonia.txt"
FSP = "countries/French Spain.txt"
CSF = "countries/Caribbean stabilization force.txt"
RHI = "countries/Rhine.txt"
DPR = "countries/Donetsk PR.txt"
FR1 = "countries/France1.txt"
DMT = "countries/Dalmatia.txt"
WLC = "countries/Wallachia.txt"
IRA = "countries/IRA.txt"
BDN = "countries/Biden forces in Midwest.txt"
CHQ = "countries/Chicago.txt"
APC = "countries/Appalachian Rangers Association.txt"
UC1 = "countries/Appalachian Constitutionalists.txt"
PHY = "countries/Philidelphia.txt"
PIT = "countries/Pittsburg.txt"
LST = "countries/Confederate Tennessee.txt"
ACP = "countries/Rural Peoples Militia.txt"
####INDIAN CIVIL WAR####
LRJ = "countries/Liberal India.txt"
KHL = "countries/Khalistan.txt"
KSS = "countries/Kashmir ISIS.txt"
PRJ = "countries/PRC Intervention Forces.txt"
UPJ = "countries/Uttar Pradesh Clique.txt"
MPJ = "countries/Madhaya Pradesh Clique.txt"
SAJ = "countries/Southern Indian Military Junta.txt"
DRV = "countries/Dravida Nadu.txt"
RSS = "countries/Fascist India.txt"
SLJ = "countries/Salwa Judum.txt"
SKM = "countries/Sikkim.txt"
NBG = "countries/North Eastern Military Command.txt"
TIG = "countries/Muslim Tigers.txt"
RJN = "countries/Indian Naval Junta.txt"
####################for trading
SV1 = "countries/SovietTrade.txt"
US1 = "countries/USTrade.txt"
US2 = "countries/USTrade2.txt"
US3 = "countries/USTrade3.txt"
UK1 = "countries/UKTrade.txt"
IS1 = "countries/ISTrade.txt"
A24 = "countries/a24.txt"
#Anarchy
ZZZ = "countries/ZZZ_Anarchy.txt" #Anarchy Tag, must be last